0 0 0 0 0 0 0 0 0 0 17 17 17 17 0 0 0 0 0 0 0 0 0 0 0 0 0 0 0 0 0 0 0
0 17 17 17 17 17 17 17 17 17 16 0 0 15 17 17 17 17 17 17 17 17 17 0 0 0 0 0 0 0 0 0 0
0 17 18 0 9 6 1 1 1 5 9 0 0 9 6 1 1 1 5 9 0 19 17 0 0 0 0 0 0 0 0 0 0
0 17 0 0 10 6 2 2 2 5 10 0 0 10 6 2 2 2 5 10 0 0 17 0 0 0 0 0 0 0 0 0 0
0 17 11 12 13 17 17 17 17 17 14 11 12 13 17 17 17 17 17 14 11 12 17 0 0 0 0 0 0 0 0 0 0
0 17 8 8 17 0 0 0 0 0 17 8 8 17 0 0 0 0 0 17 8 8 17 0 0 0 0 0 0 0 0 0 0
0 17 3 4 17 0 0 0 0 0 17 3 4 17 0 0 0 0 0 17 3 4 17 0 0 0 0 0 0 0 0 0 0
17 16 3 4 15 17 17 17 17 17 16 3 4 15 17 17 17 17 17 16 3 4 17 0 0 0 0 0 0 0 0 0 0
17 0 3 4 0 0 0 0 0 0 0 3 4 0 0 0 0 0 0 0 3 4 17 0 0 0 0 0 0 0 0 0 0
17 14 3 4 13 17 17 17 17 17 14 3 4 13 17 17 17 17 17 14 3 4 17 0 0 0 0 0 0 0 0 0 0
0 17 3 4 17 0 0 0 0 0 17 3 4 17 0 0 0 0 0 17 3 4 17 0 0 0 0 0 0 0 0 0 0
0 17 7 7 17 0 0 0 0 0 17 7 7 17 0 0 0 0 0 17 7 7 17 0 0 0 0 0 0 0 0 0 0
0 17 11 12 15 17 17 17 17 17 16 11 12 15 17 17 17 17 17 16 11 12 15 17 17 17 17 17 17 17 17 17 0
0 17 0 0 9 6 1 1 1 5 9 0 0 9 6 1 1 1 5 9 0 0 9 6 1 1 1 5 9 0 19 17 0
0 17 20 0 10 6 2 2 2 5 10 0 0 10 6 2 2 2 5 10 0 0 10 6 2 2 2 5 10 0 0 17 0
0 17 17 17 17 17 17 17 17 17 14 11 12 13 17 17 17 17 17 14 11 12 13 17 17 17 17 17 14 11 12 17 0
0 0 0 0 0 0 0 0 0 0 17 8 8 17 0 0 0 0 0 17 8 8 17 0 0 0 0 0 17 8 8 17 0
0 0 0 0 0 0 0 0 0 0 17 3 4 17 0 0 0 0 0 17 3 4 17 0 0 0 0 0 17 3 4 17 0
0 0 0 0 0 0 0 0 0 0 17 3 4 15 17 17 17 17 17 16 3 4 15 17 17 17 17 17 16 3 4 15 17
0 0 0 0 0 0 0 0 0 0 17 3 4 0 0 0 0 0 0 0 3 4 0 0 0 0 0 0 0 3 4 0 17
0 0 0 0 0 0 0 0 0 0 17 3 4 13 17 17 17 17 17 14 3 4 13 17 17 17 17 17 14 3 4 13 17
0 0 0 0 0 0 0 0 0 0 17 3 4 17 0 0 0 0 0 17 3 4 17 0 0 0 0 0 17 3 4 17 0
0 0 0 0 0 0 0 0 0 0 17 7 7 17 0 0 0 0 0 17 7 7 17 0 0 0 0 0 17 7 7 17 0
0 0 0 0 0 0 0 0 0 0 17 11 12 15 17 17 17 17 17 16 11 12 15 17 17 17 17 17 16 11 12 17 0
0 0 0 0 0 0 0 0 0 0 17 0 0 9 6 1 1 1 5 9 0 0 9 6 1 1 1 5 9 0 0 17 0
0 0 0 0 0 0 0 0 0 0 17 20 0 10 6 2 2 2 5 10 0 0 10 6 2 2 2 5 10 0 21 17 0
0 0 0 0 0 0 0 0 0 0 17 17 17 17 17 17 17 17 17 14 0 0 13 17 17 17 17 17 17 17 17 17 0
0 0 0 0 0 0 0 0 0 0 0 0 0 0 0 0 0 0 0 17 17 17 17 0 0 0 0 0 0 0 0 0 0